...............................................................................................................................................................................
...............................................................................................................................................................................
...............................................................................................................................................................................
...............................................................................................................................................................................
...............................................................................................................................................................................
.......................................E.......................................................................................................................................
............................##################L##..............................................................................................................................
..............................................L................................................................................................................................
..............................................L................................................................................................................................
..............................................L................................................................................................................................
..............................................L................................................................................................................................
..............................................L................................................................................................................................
..............................................L................................................................................................................................
..............................................L................................................................................................................................
..............................................L................................................................................E...............................................
..............................................L..............................................................................#######L..........................................
..............................................L.....E...............................................................................L..........................................
.......................................#######L#########.............................................###............................L..........................................
@.....................................................................BB............................................................L..........................................
...........................................................................................................E........................L..........................................
..........B.......................E...............................................BBB...............................................L..........................................
.........BB...................###############....................................................................................#####.........................................
........BBBBBBB................................................................................................................................................................
........BB...............................................................BBB...................................................................................................
........BB...........B......E......B.................BBB.......................................................................................................................
###############################################################################################################################################################################
